20 65 
219 219 219 219 219 219 219 219 219 219 219 219 219 219 219 219 219 219 219 219 219 219 219 219 219 219 219 219 219 219 219 219 219 219 219 219 219 219 219 219 219 219 219 219 219 219 219 219 219 219 219 219 219 219 219 219 219 219 219 219 219 219 219 219 219 
219 177 32 32 32 32 32 32 32 32 32 32 32 32 219 32 32 32 32 32 32 32 32 32 32 32 32 32 32 32 32 32 32 32 32 32 32 32 32 32 32 32 32 32 32 32 32 32 32 219 219 32 32 219 32 32 219 219 219 219 219 219 219 219 219 
219 32 32 32 32 32 219 219 219 219 219 219 219 219 219 32 32 32 32 32 32 32 32 219 219 219 219 219 32 219 219 219 219 219 219 219 219 219 219 219 219 219 219 219 219 219 32 32 219 219 219 32 32 219 32 32 219 219 219 219 219 219 219 219 219 
219 32 32 219 219 32 32 32 32 32 32 32 32 219 32 32 32 32 32 32 32 32 32 32 32 32 32 32 32 32 32 32 32 32 32 32 32 32 219 219 32 32 32 32 32 32 32 32 32 32 32 32 32 32 32 32 32 32 32 32 32 32 219 219 219 
219 32 32 219 219 32 32 32 32 32 32 32 32 219 32 32 219 32 32 219 219 219 219 219 219 32 219 219 219 219 219 219 219 219 219 219 219 219 219 219 219 219 219 219 219 219 32 32 32 32 32 32 32 32 32 32 32 32 32 32 32 32 32 32 219 
219 32 32 219 219 32 32 32 32 32 32 32 32 219 32 32 219 32 32 32 32 32 32 32 32 32 32 32 32 32 32 32 32 32 32 32 32 32 32 32 32 32 32 32 32 32 32 32 32 32 32 32 32 219 219 219 219 219 219 219 219 219 219 219 219 
219 32 32 219 219 32 32 32 32 32 32 32 32 32 32 32 219 219 219 219 219 219 219 219 219 219 219 219 219 219 219 219 219 219 219 219 219 219 219 219 32 32 32 32 32 219 219 219 219 219 219 219 219 219 219 219 219 219 219 219 219 219 219 219 219 
219 32 32 219 219 32 32 32 219 32 32 32 32 219 219 219 219 219 219 219 219 219 219 219 219 219 219 219 32 32 32 32 32 32 32 32 32 32 32 32 32 32 32 32 32 32 32 32 32 32 32 32 219 219 219 219 32 32 32 219 32 32 32 32 219 
219 219 219 219 219 32 32 32 219 32 219 32 32 32 32 219 32 32 32 32 32 32 32 32 32 32 32 32 32 219 219 219 219 219 219 219 219 219 219 219 219 219 219 219 219 219 219 32 32 32 32 32 219 219 219 219 32 32 32 219 32 32 32 32 219 
219 219 32 32 32 32 32 32 219 32 219 32 32 32 32 219 32 32 32 32 32 32 219 219 219 219 219 219 219 219 219 219 219 219 32 32 32 32 32 32 32 32 32 32 32 32 32 32 32 32 32 32 219 219 219 219 32 32 32 219 32 32 32 32 219 
219 219 219 219 219 219 32 32 219 219 219 219 219 219 219 219 32 32 32 32 32 32 219 218 32 32 32 32 32 32 32 32 32 32 32 32 32 219 219 219 219 219 219 219 219 219 219 219 219 32 32 32 32 32 32 32 32 32 32 219 32 32 32 32 219 
219 32 32 32 32 32 32 32 32 32 32 32 32 32 32 32 32 32 32 32 32 32 219 32 32 32 219 219 219 219 219 219 219 219 219 219 32 32 32 32 219 219 219 219 219 219 219 219 219 219 219 219 219 219 219 219 32 32 32 32 219 219 219 219 219 
219 32 32 219 219 219 219 219 219 219 219 219 219 32 32 32 219 219 219 219 32 32 219 32 32 32 32 32 32 219 32 32 32 32 32 32 32 32 32 32 32 32 32 32 32 32 32 32 32 32 32 32 32 32 219 219 32 219 219 219 219 219 219 219 219 
219 219 219 219 219 219 219 32 32 219 219 219 219 219 32 32 219 219 219 219 32 32 219 32 32 32 32 32 32 219 32 32 32 32 219 219 219 219 219 219 219 219 219 219 219 219 219 219 219 219 219 219 219 32 32 32 32 32 32 32 32 32 32 32 219 
219 32 32 32 32 32 219 32 32 32 32 32 32 32 32 32 219 219 219 219 32 32 219 32 32 32 32 32 32 219 32 32 32 32 219 219 219 219 219 219 219 219 219 219 219 219 219 219 219 219 219 219 219 32 32 32 32 219 219 219 32 32 32 32 219 
219 219 219 219 32 32 219 219 219 219 219 219 219 32 219 219 219 32 32 32 32 32 219 32 32 32 32 219 219 219 219 219 219 219 219 219 219 219 219 219 219 219 219 219 219 219 219 219 219 219 219 219 219 219 32 32 32 219 219 219 32 219 219 32 219 
219 32 32 32 32 32 32 32 32 32 32 32 32 32 32 219 32 32 32 32 32 32 219 32 32 32 32 32 32 219 32 32 32 32 32 219 32 219 32 32 32 219 32 32 32 32 32 219 32 32 32 32 32 32 32 32 32 219 219 219 32 219 219 32 219 
219 32 32 219 32 32 219 219 219 219 219 219 32 32 32 32 32 32 32 32 32 32 32 32 32 32 32 32 32 219 32 32 32 32 32 219 32 219 32 32 32 219 32 32 219 219 219 219 219 219 219 219 32 32 32 32 32 219 219 219 32 219 219 32 219 
219 32 32 219 32 32 219 219 219 219 219 219 219 219 219 219 219 219 219 219 219 219 219 219 219 219 219 219 219 219 219 219 219 219 32 219 32 219 32 32 32 219 219 219 32 32 32 32 32 32 32 219 219 219 219 32 32 32 32 32 32 32 32 32 219 
219 219 219 219 219 219 219 219 219 219 219 219 219 219 219 219 219 219 219 219 219 219 219 219 219 219 219 219 219 219 219 219 219 219 219 219 219 219 219 219 219 219 219 219 219 219 219 219 219 219 219 219 219 219 219 219 219 219 219 219 219 219 219 219 219 
Score
0 
0 
0
0
0
0
0
0
0
0
time
0
0 
0 
0
0
0
0
0
0
0

